1111111111111
1C01000C00001
1000011111001
1P0011E000001
1111111111111