0000000000000
0C00000000000
0000000000000
0P0011E0000C0
0000000000000